20
14
"Alien Cave Entry"

 3,3,3,3,3,3,3,3,3,3,3,3,3,3,3,3,3,3,3,3
 3,3,3,3,3,3,3,3,3,3,3,3,3,3,3,3,3,3,3,3
 3,3,3,3,3,3,2,2,2,2,2,2,2,2,2,2,2,2,2,2
 3,3,3,3,3,2,5,5,5,5,5,5,5,5,5,5,5,5,5,5
 3,3,3,3,2,5,5,5,5,5,5,5,5,5,5,5,5,5,5,5
 2,2,2,2,5,5,5,5,5,5,5,5,5,5,5,5,5,5,5,5
 1,1,1,5,5,5,5,5,5,5,5,5,5,5,5,5,5,5,5,5
 1,1,5,5,5,5,5,5,5,5,5,5,5,5,5,5,5,5,5,5
 3,3,3,3,5,5,5,5,5,5,5,5,5,5,5,5,5,5,5,5
 3,3,3,3,3,5,5,5,5,5,5,5,5,5,5,5,5,5,5,5
 3,3,3,3,3,3,5,5,5,5,5,5,5,5,5,5,5,5,5,5
 3,3,3,3,3,3,3,5,5,5,5,5,5,5,5,5,5,5,5,5
 3,3,3,3,3,3,3,3,3,3,3,3,3,3,3,3,3,3,3,3
 3,3,3,3,3,3,3,3,3,3,3,3,3,3,3,3,3,3,3,3
*WARP*
1,7,DemoMap.map,20,7
1,8,DemoMap.map,20,8
20,4,aliencave2.map,1,4
20,5,aliencave2.map,1,5
20,6,aliencave2.map,1,6
20,7,aliencave2.map,1,7
20,8,aliencave2.map,1,8
20,9,aliencave2.map,1,9
20,10,aliencave2.map,1,10
20,11,aliencave2.map,1,11
20,12,aliencave2.map,1,12
*NPC*
*SIGNS*
*GOLD*
*ARROWS*
*BOMBS*
*BUSHES*
