20
14
"Alien Cave"

 3,3,3,3,3,3,3,5,5,3,3,3,3,3,3,3,3,3,3,3
 3,3,3,3,3,3,3,5,5,2,2,2,2,2,2,2,2,2,2,2
 2,2,2,3,3,3,3,5,5,5,5,5,5,5,5,5,5,5,5,5
 5,5,5,3,3,3,3,3,3,3,3,3,3,3,3,3,3,3,3,3
 5,5,5,3,3,3,3,3,3,3,3,3,3,3,3,3,3,3,3,3
 5,5,5,2,2,2,2,2,2,2,2,2,2,2,2,2,2,2,2,3
 5,5,5,5,5,5,5,5,5,5,5,5,5,5,5,5,5,5,5,3
 5,5,5,5,5,5,5,5,5,5,5,5,5,5,5,5,5,5,5,3
 5,5,5,5,5,5,5,5,5,5,5,5,5,5,5,5,5,5,5,3
 5,5,5,5,5,5,5,5,5,5,5,5,5,5,5,5,5,5,5,3
 5,5,5,5,5,5,5,5,5,5,5,5,5,5,5,5,5,5,5,2
 5,5,5,5,5,5,5,5,5,5,5,5,5,5,5,5,5,5,5,5
 3,3,3,3,3,5,5,5,5,5,5,5,5,5,5,5,5,5,5,5
 3,3,3,3,3,3,3,3,3,3,3,3,3,3,3,3,3,3,3,3
*WARP*
1,10,aliencave1.map,20,10
1,11,aliencave1.map,20,11
1,12,aliencave1.map,20,12
1,4,aliencave1.map,20,4
1,5,aliencave1.map,20,5
1,6,aliencave1.map,20,6
1,7,aliencave1.map,20,7
1,8,aliencave1.map,20,8
1,9,aliencave1.map,20,9
20,12,aliencave3.map,1,12
20,13,aliencave3.map,1,13
20,3,aliencave3.map,1,3
8,1,aliencave4.map,8,14
9,1,aliencave4.map,9,14
*NPC*
*SIGNS*
*GOLD*
*ARROWS*
*BOMBS*
*BUSHES*
