20
14
"Alien Cave"

 3,3,3,3,3,3,3,3,3,3,3,3,3,3,3,3,3,3,3,3
 2,2,2,2,2,2,2,2,2,2,2,2,2,2,2,2,2,2,2,3
 5,5,5,5,5,5,5,5,5,5,5,5,5,5,5,5,5,5,5,3
 3,3,3,3,3,3,3,3,3,3,3,3,3,3,3,3,3,3,5,3
 3,2,2,2,2,2,2,2,2,2,2,2,2,2,2,2,2,2,5,3
 3,5,5,5,5,5,5,5,5,5,5,5,5,5,5,5,5,5,5,3
 3,5,3,3,3,3,3,3,3,3,3,3,3,3,3,3,3,3,3,3
 3,5,2,2,2,2,2,2,2,2,2,2,2,2,2,2,2,2,2,3
 3,5,5,5,5,5,5,5,5,5,5,5,5,5,5,5,5,5,5,3
 3,3,3,3,3,3,3,3,3,3,3,3,3,3,3,3,3,3,5,3
 2,2,2,2,2,2,2,2,2,2,2,2,2,2,2,2,3,3,5,3
 5,5,5,5,5,5,5,5,5,5,5,5,5,5,5,5,2,2,5,3
 5,5,5,5,5,5,5,5,5,5,5,5,5,5,5,5,5,5,5,3
 3,3,3,3,3,3,3,3,3,3,3,3,3,3,3,3,3,3,3,3
*WARP*
1,3,aliencave2.map,20,3
1,12,aliencave2.map,20,12
1,13,aliencave2.map,20,13
*NPC*
*SIGNS*
*GOLD*
*ARROWS*
*BOMBS*
*BUSHES*
