20
14
"Alien Cave"

 4,4,4,4,4,4,4,4,4,4,4,4,4,4,4,4,4,4,4,4
 4,4,4,4,4,4,4,4,4,4,4,4,4,4,4,4,4,4,4,4
 4,4,4,4,4,4,4,4,4,4,4,4,4,4,4,4,4,4,4,4
 4,4,4,4,4,4,4,4,4,4,4,4,4,4,4,4,4,4,4,4
 3,3,3,3,3,3,3,3,3,3,3,3,3,3,3,3,3,3,3,3
 3,3,3,3,3,3,3,3,3,3,3,3,3,3,3,3,3,3,3,3
 3,3,3,2,2,3,3,2,2,3,3,3,2,2,3,3,2,2,3,3
 3,3,3,5,28,3,3,5,28,3,3,3,5,28,3,3,5,28,3,3
 3,3,3,5,5,3,3,5,5,3,3,3,5,5,3,3,5,5,3,3
 3,3,3,5,5,3,3,5,5,3,3,3,5,5,3,3,5,5,3,3
 3,3,3,5,3,3,3,5,3,3,3,3,5,3,3,3,5,3,3,3
 3,3,3,5,3,3,3,5,3,3,3,3,5,3,3,3,5,3,3,3
 3,3,3,5,3,3,3,5,3,3,3,3,5,3,3,3,5,3,3,3
 3,3,3,5,3,3,3,5,3,3,3,3,5,3,3,3,5,3,3,3
*WARP*
13,14,aliencave4.map,13,1
8,14,aliencave4.map,8,1
17,14,aliencave4.map,17,1
4,14,aliencave4.map,4,1
*NPC*
*SIGNS*
*GOLD*
*ARROWS*
*BOMBS*
*BUSHES*
