20
14
"Alien Cave"

 3,3,3,5,3,3,3,5,3,3,3,3,5,3,3,3,5,3,3,3
 3,3,3,5,3,3,3,5,3,3,3,3,5,3,3,3,5,3,3,3
 3,3,3,5,3,3,3,5,3,3,3,3,5,3,3,3,5,3,3,3
 3,3,3,5,3,3,3,5,3,3,3,3,5,3,3,3,5,3,3,3
 3,3,3,5,3,3,3,5,3,3,3,3,5,3,3,3,5,3,3,3
 3,3,3,5,3,3,3,5,3,3,3,3,5,3,3,3,5,3,3,3
 3,3,3,5,3,3,3,5,3,3,3,3,5,3,3,3,5,3,3,3
 3,3,3,5,3,3,3,5,3,3,3,3,5,3,3,3,5,3,3,3
 3,3,3,5,3,3,3,5,3,3,3,3,5,3,3,3,5,3,3,3
 3,3,3,5,3,3,3,5,3,3,3,3,5,3,3,3,5,3,3,3
 3,3,3,5,3,3,3,5,3,3,3,3,5,3,3,3,5,3,3,3
 3,2,2,5,2,2,2,5,2,2,2,2,5,2,2,2,5,2,2,3
 3,5,5,5,5,5,5,5,5,5,5,5,5,5,5,5,5,5,5,3
 3,3,3,3,3,3,3,5,5,3,3,3,3,3,3,3,3,3,3,3
*WARP*
13,1,aliencave5.map,13,14
17,1,aliencave5.map,17,14
4,1,aliencave5.map,4,14
8,1,aliencave5.map,8,14
8,14,aliencave2.map,8,1
9,14,aliencave2.map,9,1
*NPC*
*SIGNS*
*GOLD*
*ARROWS*
*BOMBS*
*BUSHES*
