20
14
"DemoMap"
wildarms.mid
 3,3,3,3,3,3,3,3,3,3,3,3,3,3,3,3,3,3,3,3
 3,3,3,2,2,2,2,2,2,2,2,2,2,2,2,2,2,3,3,3
 3,3,2,29,1,1,1,1,1,1,1,1,1,1,1,1,1,2,3,3
 3,2,1,1,1,1,1,1,1,1,1,1,1,1,1,1,1,1,2,3
 3,1,1,1,1,1,1,1,1,1,1,1,1,1,1,1,1,1,1,3
 3,1,1,1,1,1,1,1,1,3,3,1,1,1,1,1,1,1,1,2
 3,1,1,1,1,1,1,1,3,3,3,3,1,1,1,1,1,1,1,1
 3,1,1,1,1,1,1,1,3,3,3,3,1,1,1,1,1,1,1,1
 3,1,1,1,1,1,1,1,2,3,3,2,1,1,1,1,1,1,1,3
 3,1,1,1,1,1,1,1,1,2,2,1,1,1,1,1,1,1,1,3
 3,1,1,1,1,1,1,1,1,1,1,1,1,1,1,1,1,1,1,3
 3,1,1,1,1,1,1,1,1,1,1,1,1,1,1,1,1,1,1,3
 3,3,1,1,1,1,1,1,1,1,1,1,1,1,1,1,1,1,3,3
 3,3,3,3,3,3,3,3,3,1,1,3,3,3,3,3,3,3,3,3
*WARP*
11,14,map2.map,11,1
20,8,aliencave1.map,1,8
10,14,map2.map,10,1
20,7,aliencave1.map,1,7
*NPC*
Guy,Guy1.NPC,aXile0.ico,2,11,63,63
*SIGNS* 
4,3,Hello Traveler.  Welcome to the world of Dragon Field.  Press the TAB key to access your statistics and the ~ key to access your weapons.  Press F1 for options.
*GOLD*
*ARROWS*
*BOMBS*
*BUSHES*
