20
14
"You Have Been Jailed"

 11,10,10,10,10,10,10,10,10,10,10,10,10,10,10,10,10,10,10,12
 9,3,3,3,3,3,3,3,3,3,3,3,3,3,3,3,3,3,3,9
 9,3,2,2,2,2,2,2,2,2,2,2,2,2,2,2,2,2,3,9
 9,3,4,30,30,30,4,4,4,4,4,4,4,4,30,29,1,1,3,9
 9,3,4,30,7,30,4,4,4,4,4,4,4,4,30,1,1,1,3,9
 9,3,4,4,4,4,4,4,4,4,4,4,4,4,30,1,1,1,3,9
 9,3,4,4,4,4,4,4,4,4,4,4,4,4,30,19,30,30,3,9
 9,3,4,4,4,4,4,4,4,4,4,4,4,4,4,4,4,4,3,9
 9,3,20,20,20,20,4,4,4,4,4,4,4,4,4,4,4,4,3,9
 9,3,1,1,1,1,20,4,4,4,4,4,4,4,4,4,4,4,3,9
 9,3,1,1,1,1,1,18,4,4,4,4,4,4,4,4,4,4,3,9
 9,3,3,3,3,3,3,3,3,3,3,3,3,3,3,3,3,3,3,9
 9,2,2,2,2,2,2,2,2,2,2,2,2,2,2,2,2,2,2,9
 13,10,10,10,10,10,10,10,10,10,10,10,10,10,10,10,10,10,10,14
*WARP*
*NPC*
*SIGNS*
16,4,Here is a corner to think about your sins.
*GOLD*
*ARROWS*
*BOMBS*
*BUSHES*
