20
14
"Map2"

 3,3,3,3,3,3,3,3,3,1,1,3,3,3,3,3,3,3,3,3
 3,3,3,2,2,2,2,2,2,1,1,2,2,2,2,2,2,3,3,3
 3,3,2,1,1,1,1,1,1,1,1,1,1,1,1,1,1,2,3,3
 3,2,1,1,1,1,1,1,1,1,1,1,1,1,1,1,1,1,2,3
 3,1,1,1,1,1,1,1,1,1,1,1,1,1,1,1,1,1,1,3
 3,1,1,1,1,1,1,1,1,3,3,1,1,1,1,1,1,1,1,3
 3,1,1,1,1,1,1,1,3,3,3,3,1,1,1,1,1,1,1,3
 3,1,1,1,1,1,1,1,3,3,3,3,1,1,1,1,1,1,1,3
 3,1,1,1,1,1,1,1,2,3,3,2,1,1,1,1,1,1,1,3
 3,1,1,1,1,1,1,1,1,2,2,1,1,1,1,1,1,1,1,3
 3,1,1,1,1,1,1,1,1,1,1,1,1,1,1,1,1,1,1,3
 3,1,1,1,1,1,1,1,1,1,1,1,1,1,1,1,1,1,1,3
 3,3,1,1,1,1,1,1,1,1,1,1,1,1,1,1,1,1,3,3
 3,3,3,3,3,3,3,3,3,4,3,3,3,3,3,3,3,3,3,3
*WARP*
10,1,DemoMap.map,10,14
11,1,DemoMap.map,11,14
10,14,Outside1.map,8,4
*NPC*
*SIGNS*
*GOLD*
*ARROWS*
*BOMBS*
*BUSHES*
