20
14
"Outside 1"

 3,3,3,3,3,3,3,3,3,3,3,3,3,3,3,3,3,3,3,3
 3,3,3,3,3,3,3,3,3,3,3,3,3,3,3,3,3,3,3,3
 3,2,2,2,2,2,2,6,2,2,2,2,2,2,2,2,2,2,2,2
 3,4,4,4,4,4,27,1,27,4,4,4,4,4,4,4,4,4,4,4
 3,4,4,4,4,4,1,1,1,4,4,4,4,4,4,4,4,4,4,4
 3,4,4,4,4,4,1,1,1,4,4,4,4,4,4,4,4,4,4,4
 3,4,4,4,4,4,1,1,1,4,4,4,4,4,4,4,4,4,4,4
 3,4,4,4,4,4,1,1,1,4,4,4,4,4,4,4,4,4,4,4
 3,4,4,4,4,4,1,1,1,4,4,4,4,4,4,4,4,4,4,4
 3,4,4,4,4,4,1,1,1,1,1,1,1,1,1,1,1,1,1,1
 3,4,4,4,4,4,1,1,1,1,1,1,1,1,1,1,1,1,1,1
 3,4,4,4,4,4,1,1,1,1,1,1,1,1,1,1,1,1,1,1
 3,4,4,4,4,4,4,4,4,4,4,4,4,4,4,4,4,4,4,4
 3,3,3,3,3,3,3,3,3,3,3,3,3,3,3,3,3,3,3,3
*WARP*
20,10,outside2.map,1,10
20,11,outside2.map,1,11
20,12,outside2.map,1,12
20,13,outside2.map,1,13
20,4,outside2.map,1,4
20,5,outside2.map,1,5
20,6,outside2.map,1,6
20,7,outside2.map,1,7
20,8,outside2.map,1,8
20,9,outside2.map,1,9
8,4,Map2.map,10,14
*NPC*
*SIGNS*
*GOLD**ARROWS*
*BOMBS*
*BUSHES*
